1121131121
1000000001
1010301002
3020101001
1011102004
1010001001
2012111101
1000010103
2800020001
1113112191