11119111111111111111
11010100000000000001
10010101111110101111
10110101000000100001
10000111111110100001
10111100101010100001
10010100101010111101
10010000101011100001
10000010101010100001
10101010100010100001
10101000000010100001
10001010001010100001
10100010101000100001
10000000101000110111
10111111111000000001
10010055001005555001
10000000001000000001
11111111111005555001
78000000000000000001
11111111111111111111