131121211111211111211312111333
900001000000000000000000000001
133103013311011000000100001001
104103000041001123001210011103
301101232111001000000100001001
101000000100001000000131111111
103001110100001000010100001001
101001020100001000010100102004
301002010201311212110100101001
101000010100103000010100303001
102066010100103044010100301002
301000020100001000010355101001
101111110121102300010213102001
101000000001000000020000001002
101311131201211121211102201001
201400100301000000000102101004
111120320101000000000101301001
200000010101006060600000001001
100300020101000000000000001001
100000110201006060600000001003
200100100102000000000000001001
100000200000000000000000001001
100100121121211112111110323101
100000001000000000000430000001
100100113020121141121110000001
300000000010000000000010112001
100100000021212110000020111001
200000001010004100000010000003
100000002000004100000000000081
111111221131313111251114113171